XXXXX
X   X
X XXX
X   X
X XXX
X   X 
XXXXX